!!ATOK_TANGO_TEXT_HEADER_1
!!一覧出力
!!対象辞書;
!!単語種類;登録単語(*)
!!出力日時;2018-05-10 00:00:00 +0000

あさくらとおる	浅倉透	固有人名*
あさひ	あさひ	固有人名*
あまな	甘奈	固有人名*
ありすがわなつは	有栖川夏葉	固有人名*
いずみめい	和泉愛依	固有人名*
いそべかりん	磯部花凜	固有人名*
いちかわひなな	市川雛菜	固有人名*
おおさきあまな	大崎甘奈	固有人名*
おおさきてんか	大崎甜花	固有人名*
おかさきみほ	岡咲美保	固有人名*
かざのひおり	風野灯織	固有人名*
かほ	果穂	固有人名*
きたはらさやか	北原沙弥香	固有人名*
きりこ	霧子	固有人名*
くろきほのか	黒木ほの香	固有人名*
くわやまちゆき	桑山千雪	固有人名*
こいと	小糸	固有人名*
こうのひより	河野ひより	固有人名*
こがね	恋鐘	固有人名*
こみやかほ	小宮果穂	固有人名*
こんどうれいな	近藤玲奈	固有人名*
さいじょうじゅり	西城樹里	固有人名*
さくや	咲耶	固有人名*
さくらぎまの	櫻木真乃	固有人名*
しばさきのりこ	芝崎典子	固有人名*
しらいしはるか	白石晴香	固有人名*
しらせさくや	白瀬咲耶	固有人名*
じゅり	樹里	固有人名*
すがぬまちさ	菅沼千紗	固有人名*
すずもとあきほ	涼本あきほ	固有人名*
せきねひとみ	関根瞳	固有人名*
せりざわあさひ	芹沢あさひ	固有人名*
そのだちよこ	園田智代子	固有人名*
たじまさらん	田嶌紗蘭	固有人名*
たなかまみみ	田中摩美々	固有人名*
たなかゆき	田中有紀	固有人名*
ちゆき	千雪	固有人名*
ちよこ	智代子	固有人名*
つきおかこがね	月岡恋鐘	固有人名*
つちやりお	土屋李央	固有人名*
てんか	甜花	固有人名*
とおる	透	固有人名*
ながいまりこ	永井真里子	固有人名*
なつは	夏葉	固有人名*
なるみるな	成海瑠奈	固有人名*
はちみやめぐる	八宮めぐる	固有人名*
ひおり	灯織	固有人名*
ひぐちまどか	樋口円香	固有人名*
ひなな	雛菜	固有人名*
ふくまるこいと	福丸小糸	固有人名*
ふゆこ	冬優子	固有人名*
まえかわりょうこ	前川涼子	固有人名*
まどか	円香	固有人名*
まの	真乃	固有人名*
まみみ	摩美々	固有人名*
まゆずみふゆこ	黛冬優子	固有人名*
まるおかわかな	丸岡和佳奈	固有人名*
みつみねゆいか	三峰結華	固有人名*
みねだまゆ	峯田茉優	固有人名*
めい	愛依	固有人名*
めぐる	めぐる	固有人名*
もりのりんぜ	杜野凛世	固有人名*
やまきあんな	八巻アンナ	固有人名*
ゆいか	結華	固有人名*
ゆいなみづき	結名美月	固有人名*
ゆうこくきりこ	幽谷霧子	固有人名*
ゆきむらえり	幸村恵理	固有人名*
りんぜ	凛世	固有人名*
わくいゆう	和久井優	固有人名*
